##########
#        #
#        #
#        #
#        #
#        #
#        ###########
#                  #
#                  #
#                  #
####################