~~~~~~########~~~~~~########~~~~~~
~~~~~~#      #~~~~~~#      #~~~~~~
~~~~~~#      #~~~~~~#      #~~~~~~
~~~~~~#      #~~~~~~#      #~~~~~~
~~~~~~#      #~~~~~~#      #~~~~~~
~~~~~~#      #~~~~~~#      #~~~~~~
#######      ########      #######
#                                #
#                                #
#                                #
#######      ########      #######
~~~~~~#      #~~~~~~#      #~~~~~~
~~~~~~#      #~~~~~~#      #~~~~~~
~~~~~~#      #~~~~~~#      #~~~~~~
~~~~~~#      #~~~~~~#      #~~~~~~
~~~~~~#      #~~~~~~#      #~~~~~~
~~~~~~#      #~~~~~~#      #~~~~~~
~~~~~~########~~~~~~########~~~~~~